10
10
100
5 3 0 3 0 3 0 3 0 9
0 0 0 0 3 0 3 0 0 0
0 0 3 0 0 0 0 0 0 0
0 0 0 0 0 0 0 3 0 0
0 0 3 0 0 0 0 0 0 0
0 0 0 0 3 0 0 0 0 0
0 0 0 0 0 0 0 0 0 0
0 0 0 3 0 0 0 0 0 0
0 3 0 0 0 0 0 0 0 0
0 0 0 0 0 0 0 0 0 0